1111111111111111111111111111
101EP00000000100000000000001
1011101000000111000000000001
1000010000000111111100000001
1000000000000100000000000001
1000001000C0010000000C000001
1000001000000100000000000001
1000000000000100000000000001
1000001000000111111100000001
1000001000000000000000000001
1000001000000000000000111001
10000010000000000000000C1001
1000001000000000000000111001
1111111111111111111111111111