111111
101P11
100101
1000E1
111111